
NO srcs/pics/angery.png     

SO srcs/pics/crai.png 
WE            srcs/pics/bluestone.png

R 1920 1080

EA srcs/pics/dead.png


S srcs/pics/dead.png


F 220,100,0
C 225,30,0

        1111111111111111111111111   11111111111111     10
        1000000000110000000000001   10000000000001     10
        1011000001110000002000001   10000011110001     10 
        10010000000000000000000011111000001  10001
11111111101100000111000000000000000000000011110001
10000000001100000111011111111111111110000000000001
11110111111111011100000010001       11111111111111
11110111111111011101010010001
11000000110101011100000010001
10002000000000001100000010001             
10000000000000001101010010001
11000001110101011111011110N0111
11110111 1110101 101111010001
11111111 1111111 111111111111
1       1                    1

hello world!