
NO srcs/pics/bluestone.png     

SO srcs/pics/purplestone.png 
WE            srcs/pics folder/grey stone.png      

R 16384 500

EA srcs/pics/colorstone.xpm


S srcs/pics/dead.png


F                  255,255,255
C 0,0,0

111111111111111111111111
100000000011000000000001
102200000111000000000001
100200000000000000000001
102200000111000000000001
100000000022000001110111
111101111111111111000001
122202222020202022020201
110000001101010111000001
100000000000000011000001
100000000000000011010101
110000002202020211220121
111101111111011111110121
122202222111002011000001
120000021100000011000001
100000001100000011000001 
100000001222222022200021
100000002221222110020201
120000022200022010100021
100000002000002202020201
10000000000N000000000001
100000002000002202020201
120000022200022020200021
111111111111111111111111
  1