
NO srcs/pics/greystone.png     

SO srcs/pics/mossy.png
         WE             srcs/pics/wood.png

R 1920 1080

EA srcs/pics/bluestone.png


S srcs/pics/barrel.png


F 255,  255,   255
C 225,  30,  0

        1111111111111111111111111   11111111111111
        1000000000110000000000001   10000000000001
        1011000001110000002000001   1000N011110001
        10010000000000000000000011111000001  10001
11111111101100000111000000000000000000000011110001
10000000001100000111011111111111111110000000000001
11110111111111011100000010001       11111111111111
11110111111111011101010010001
11000000110101011100000010001
10002000000000001100000010001
10000000000000001101010010001
1100000111010101111101111000111
11110111 1110101 101111010001
11111111 1111111 111111111111 