
NO srcs/pics/angery.png     

SO srcs/pics/crai.png 
WE            srcs/pics/bluestone.png

R 1920 1080

EA srcs/pics/dead.png


S srcs/pics/dead.png


F 252,252,252
C 222,30,0

        1111111111111111111111111   11111111111111
        1000000000110000000000001   10000000000001
        1011000001110000022200001   1220E011110001
        10010000000000000222000011111220001  10001
11111111101100000111000002220000000000000011110001
10000000000000000000000000000000111110000000000001
10000000001100000111011111111111111110000000000001
11110111111111011100000010001       11111111111111
11110111111111011101010010001
11000000110101011100000010001
10002000200000001100000010001
10000000000000001101010010001
1100000111010101111101111000111
11110111 1110101 101111010001
11111111 1111111 111111111111