R 500 500
NO ./srcs/pics/bigbigbig.png
SO ./srcs/pics/purplestone.png
EA ./srcs/pics/crai.png
WE ./srcs/pics/mossy.png
S ./srcs/pics/bigthink.png

C 255,200,255
F 122,122,122

        1111111111111111111111111   11111111111111
        1000000000110000000000001   10000000000001
        1011000001110000022200001   12200N11110001
        10010000000000000222000011111220001  100011
111111111011000001110000022200000000000000111100001
100000000000000000000000000000001111100000000000011
10000000001100000111011111111111111110000000000001
11110111111111011100000010001       11111111111111
11110111111111011101010010001
11000000110101011100000000001
10002000200000001100000010001
10000000000000001101010010001
1100000111010101111101111000111
10010111 1110101 101111010001
11111111 1111111 111111111111