
NO srcs/pics/angery.png     

SO srcs/pics/crai.png 
WE            srcs/pics/bluestone.png

R 1920 1080

EA srcs/pics/dead.png


S srcs/pics/dead.png


F 252,252,252
C 222,30,0

111111111111111
122222222222221
1222222N2222221
122222222222221
122222222222221
122222222222221
122222222222221
122222222222221
122222222222221
122222222222221
122222222222221
122222222222221
111111111111111