R 800 4000
NO srcs/cube_functions/textures/barrel.png
EA srcs/cube_functions/textures/bluestone.xpm
WE srcs/cube_functions/textures/greenlight.xpm
SO srcs/cube_functions/textures/eagle.xpm
S srcs/cube_functions/textures/barrel.png
F 100,100,100
C 00200,00200,00200

        1111111111111111111111111   11111111111111     10
        1000000000110000000000001   10000000000001     10
        1011000001110000002000001   10000011110001     10 
        100100000000000000S0000011111000001  10001
11111111101100000111000222222000000000000011110001
10000000001100000111011112221111111110000000000001
11110111111111011100000010001       11111111111111
11110111111111011101010010001
11000011110101011100000010001
1000201  10000001100000010001             
10000011110000001101010010001
1100000111010101111101111000111
11110111 1110101 101111010001
11111111 1111111 111111111111
1       1                    1