111111111111
100000000001
110000N00001
100000000001
111111111111